################
#              #
#              #
#   C       @  #
#              #
#              #
#              #
#L     XX     G#
#              #
#              #
#              #
#   D    C  S  #
#   D         S#
#              #
#              #
################